00000000000000000000000000000000000000000
00000011111111111111111111111111111000000
00000010000000000000000000000000001111111
00000010000000000000000000000000000000031
00000110000000000000000000000000000000031
00000100000100000111111111000000000000031
00011100000100000100000000000000001111110
00110000000100000100000000000000001000000
00104000000100400100000000000000001000000
00100000000100000010000000000000001000000
00100000000000000001000000000011111000000
00100000000000000000000000000010000000000
00111111111111111111111100000010000000000
00000000000000000000000111000010000000000
00000000000001111111111100000011111111110
00000000000001000000000001111000000000010
00000000000001000000000000000000000000010
00000000000001000011111111111110000000010
00000000000001000000040000000000000000010
00000000000001111111111111111111111111110